Dennis the Menace: knocking something over ("Oh Oh!")
Quaker Oats guy: offering bowl of oatmeal (OAts)
Chief O'Brien (_Star Trek_): beaming something down
PERSONAL-- Jay O'Connell: chasing kids
Jimi Hendrix: shooting up heroin (OD'ing)
J.R.R. Tolkien: struggling to hold complete unabridged OED (Old English and Oxford English Dictionary)
Richard Stallman: giving "boy scout salute" as St. Ignucius (Operating System)
Og ("CaveTech" sketch, Three Dead Trolls in a Baggie): sharpening stick
Meg Ryan in _When Harry Met Sally_: faking orgasm (OH!)
Gerard O'Neill: floating in microgravity
Great Prophet Zarquon (_The Hitch Hiker's Guide to the Galaxy_): nervously checking watch (Alpha & Omega)
"Bill" (founder of Alcoholics Anonymous): faceless and swilling booze
Abba (pop group): lip-syncing and dancing (to "Dancing Queen")
Alastair Cooke: climbing stairs (_Upstairs, Downstairs_)
Jesus: being crucified (Anno Domini)
Albert Einstein: writing on a blackboard
Isaac Asimov: shaking a robot's hand
Art Garfunkel: singing heart out with head thrown back ("Bridge Over Troubled Water")
Adolf Hitler: sieg-heiling
Andy Griffith: flashing sheriff's badge
Buddha: sitting cross-legged under the Bo tree
Bill Atkinson (Macintosh developer): breaking into pixels
Bilbo Baggins: puffing pipe in bare feet
Thor (_B.C._): riding stone unicycle
BD (_Doonesbury_): crawling through jungle wearing football helmet
Jean-Paul Sartre: smoking cigarette and drinking coffee (_BEing and Nothingness_)
Bart Simpson (_The Simpsons_): riding a skateboard
Bill Gates: counting money and chuckling evilly
PERSONAL-- Greg Burns: coming out of office (BHAPI)
Ben Franklin: flying a kite (BeN)
Cowardly Lion (Bert Lahr in _The Wizard of Oz_): bashfully fidgeting with tail (COwardly)
Charles Atlas: lifting weights over head
Charlie Brown: missing the football
Charlie Chaplin: twirling cane and waddling
Charlie Daniels: fiddling like hell
Macron alien (Eon's Cosmic Encounter game art): towering high overhead (CE = Cosmic Encounter)
CS Lewis (portrayed by Anthony Hopkins in _Shadowlands_): stepping into the Wardrobe
Buzz Lightyear from _Toy Story_: blasting off with a jetpack (CGI = Computer-Generated Imagery)
Charles Hinton (wearing top hat): manipulating hypercubes
Charles Nelson Reilly: holding up a card on _The Match Game_
Fred Flintstone: breaking rocks in the quarry (Yabba dabba DOo!)
Douglas Adams: putting a Babelfish into ear (_The Hitch Hiker's Guide to the Galaxy_)
PERSONAL-- Doug Buchanan (uncle): getting abducted by UFO
George Washington: chopping down cherry tree (Washington DC)
Danny Dunn (fictional character): descending in a bathysphere
PERSONAL-- Don Evans (uncle): shooting at tin cans
Ivan Stang (a.k.a. Doug Smith): ranting on a soapbox
PERSONAL-- My first dog, Tag: joyously wagging tail
Douglas Hofstadter: recursively holding a picture of himself
Dan (_Roseanne_ TV show): wearing sunglasses to switch on Christmas lights
Ludwig Zamenhof: grinding a lens (E-o = EsperantO)
Eris: throwing an Apple (Eris/Apple, 51 = 3x17)
Stuart Little (tiny fictional mouse wearing street clothes): paddling a boat (author E.B. White)
Elvis Costello: looking into a bar mirror ("Beyond Belief")
Edward (_Cowboy Bebop_): turning a backflip
Reepicheep (human-sized mouse from _Chronicles of Narnia_): wearing a cloak), brandishing a rapier (rEEpichEEp)
PERSONAL-- Master Heinrich von Stadten of Ezra Stiles College at Yale: speaking at podium
Valentine Michael Smith (_Stranger in a Strange Land_): sharing water naked ("I am only an EGg!")
Edward Everett Horton: tying bowtie
Ender (_Ender's Game_: small boy in military uniform), playing a videogame
PERSONAL-- Marty: kissing me (Significant Other)
Samuel Adams: brewing beer in a big vat
Sam Beckett/Scott Bakula (_Quantum Leap_): "leaping"
PERSONAL-- "Claus", former Seattle Cosmic mascot: peering over tinted glasses
PERSONAL-- Steve Dupree (friend): playing a board game
Apu (_The Simpsons_): pouring a Skwishee (Seven Eleven)
Samantha Stevens (_Bewitched_): wiggling nose
Sam Gamgee (_The Lord of the Rings_): planting a tree
Sparrowhawk (_A Wizard of Earthsea_): parleying with a dragon
Shub Niggurath (from the Cthulhu Mythos): spawning abominations
God (bearded sky-god): throwing thunderbolt
Ray Charles: playing piano and singing ("GeorgiA")
George W. Bush: clearing brush in Crawford, TX
Graham Chapman: throwing open windows and exposing himself (scene from _The Life of Brian_)
Gandhi: spinning on a wheel
General Electric (a robot in uniform): saluting
Smeagol-Gollum (_The Lord of the Rings_): falling into lava with the One Ring
Gandalf the Grey (_The Lord of the Rings_): barring the way with staff
George Harrison: tapping foot and playing guitar
Ignatius Loyola: flogging himself (iGNatius)
Santa Claus: laughing until belly shakes (HO HO HO!)
Julia Sweeney: dressing gender-ambiguously (_God Said HA!_)
Humphrey Bogart: pulling the brim of his hat low
Hagbard Celine (_Illuminatus!_): piloting golden submarine
Howard Dean: whooping
Isaac Newton (long white wig): releasing helium balloons (Newtonmas, HE HE HE!)
Homer Simpson (_The Simpsons_): gobbling donuts
Mercury (Greek god): flying with winged sandals (Hg = chemical symbol for mercury)
Hermann Hesse (author of _The Glass Bead Game_): telling beads
Han Solo (_Star Wars_): firing blaster
Dr. No: manipulating controls in his secret headquarters
Neil Armstrong: stepping onto Moon
Norman Bates: stabbing someone repeatedly
David Sedaris (author): chasing rolling coins down the street (North Carolina)
Nick Danger (Firesign Theatre, Phil Proctor): walking into a red sandstone building (oof!)
Neelix (_Star Trek_): cooking alien food
Hiro Protagonist (_Snow Crash_): cutting someone to bits with a katana (Neal Stephenson, author)
Morpheus (_The Sandman_): strewing sand (Neil Gaiman, author)
Nathaniel Hawthorne: tearing open his shirt to reveal a scarlet letter
Nick Nolte: falling into pool (scene from _Down and Out in Beverly Hills_)
